{
  "map_id": "test_map",
  "map_name": "测试地图",
  "width": 20,
  "height": 15,
  "tile_size": 16,
  "collision_layer": [
    1,1,1,1,1,1,1,1,1,1,1,1,1,1,1,1,1,1,1,1,
    1,0,0,0,0,0,0,0,0,0,0,0,0,0,0,0,0,0,0,1,
    1,0,0,0,0,0,0,0,0,0,0,0,0,0,0,0,0,0,0,1,
    1,0,0,0,0,0,0,0,0,0,0,0,0,0,0,0,0,0,0,1,
    1,0,0,0,0,0,1,1,1,1,1,1,1,0,0,0,0,0,0,1,
    1,0,0,0,0,0,1,0,0,0,0,0,1,0,0,0,0,0,0,1,
    1,0,0,0,0,0,1,0,0,0,0,0,1,0,0,0,0,0,0,1,
    1,0,0,0,0,0,1,0,0,0,0,0,1,0,0,0,0,0,0,1,
    1,0,0,0,0,0,1,1,0,0,1,1,1,0,0,0,0,0,0,1,
    1,0,0,0,0,0,0,0,0,0,0,0,0,0,0,0,0,0,0,1,
    1,0,0,0,0,0,0,0,0,0,0,0,0,0,0,0,0,0,0,1,
    1,0,0,0,0,0,0,0,0,0,0,0,0,0,0,0,0,0,0,1,
    1,0,0,0,0,0,0,0,0,0,0,0,0,0,0,0,0,0,0,1,
    1,0,0,0,0,0,0,0,0,0,0,0,0,0,0,0,0,0,0,1,
    1,1,1,1,1,1,1,1,1,1,1,1,1,1,1,1,1,1,1,1
  ],
  "spawn_point": {
    "x": 10,
    "y": 12
  }
}
